//MAP CONVERTED BY dmm2tgm.py THIS HEADER COMMENT PREVENTS RECONVERSION, DO NOT REMOVE
"a" = (
/turf/cordon,
/area/space)
"u" = (
/obj/item/trash/sosjerky,
/turf/open/indestructible/bingle,
/area/misc/bingle_pit)
"D" = (
/turf/closed/indestructible/bingle,
/area/misc/bingle_pit)
"H" = (
/obj/effect/area_lighting_helper,
/turf/open/indestructible/bingle,
/area/misc/bingle_pit)
"L" = (
/turf/open/indestructible/bingle,
/area/misc/bingle_pit)
"T" = (
/obj/item/storage/backpack/duffelbag/med/surgery,
/turf/open/indestructible/bingle,
/area/misc/bingle_pit)
"U" = (
/turf/open/space/basic,
/area/space)
"V" = (
/obj/effect/mob_spawn/corpse/human/skeleton,
/turf/open/indestructible/bingle,
/area/misc/bingle_pit)
"Z" = (
/obj/structure/table/optable,
/turf/open/indestructible/bingle,
/area/misc/bingle_pit)

(1,1,1) = {"
a
a
a
a
a
a
a
a
a
a
a
a
a
a
a
a
a
a
a
a
a
a
a
a
a
a
a
a
a
a
a
a
a
a
a
a
a
a
"}
(2,1,1) = {"
a
a
a
a
a
a
a
a
a
a
a
a
a
a
a
a
a
a
a
a
a
a
a
a
a
a
a
a
a
a
a
a
a
a
a
a
a
a
"}
(3,1,1) = {"
a
a
U
U
U
U
U
U
U
U
U
U
U
U
U
U
U
U
U
U
U
U
U
U
U
U
U
U
U
U
U
U
U
U
U
U
a
a
"}
(4,1,1) = {"
a
a
U
U
U
U
U
U
U
U
U
U
U
U
D
D
D
D
D
D
D
D
D
U
U
U
U
U
U
U
D
D
D
U
U
U
a
a
"}
(5,1,1) = {"
a
a
U
U
U
U
U
D
D
D
D
D
D
D
D
L
L
L
L
L
L
L
D
U
U
U
D
D
D
D
D
L
D
U
U
U
a
a
"}
(6,1,1) = {"
a
a
U
U
U
U
D
D
L
L
L
L
L
L
L
L
L
L
D
L
L
L
D
U
U
U
D
L
L
L
L
L
D
D
D
U
a
a
"}
(7,1,1) = {"
a
a
U
D
D
D
D
L
L
L
L
L
L
L
L
L
L
D
D
L
L
L
D
D
D
D
D
L
L
L
L
L
L
L
D
U
a
a
"}
(8,1,1) = {"
a
a
U
D
L
L
D
L
L
L
L
L
L
L
L
L
L
u
L
L
L
L
L
L
L
L
L
L
L
L
L
L
L
L
D
U
a
a
"}
(9,1,1) = {"
a
a
U
D
L
D
D
L
L
L
L
D
D
L
L
L
L
L
L
L
L
L
L
L
L
L
L
L
L
L
L
L
L
L
D
U
a
a
"}
(10,1,1) = {"
a
a
U
D
L
L
L
L
L
L
L
L
L
L
L
L
L
L
L
L
L
L
L
L
L
L
L
L
L
L
L
L
L
L
D
U
a
a
"}
(11,1,1) = {"
a
a
U
D
D
D
L
L
L
L
L
L
L
L
L
L
L
L
L
L
L
L
L
L
L
V
L
L
L
D
L
L
L
L
D
U
a
a
"}
(12,1,1) = {"
a
a
U
U
U
D
L
L
V
L
L
L
L
L
u
L
L
L
L
L
L
L
L
L
L
L
L
L
L
D
L
L
L
L
D
U
a
a
"}
(13,1,1) = {"
a
a
U
U
U
D
L
L
L
L
L
L
L
L
L
L
L
L
L
L
L
L
L
L
L
L
L
L
L
L
u
L
L
L
D
U
a
a
"}
(14,1,1) = {"
a
a
U
U
U
D
L
L
L
L
L
L
D
L
L
L
D
D
D
D
D
D
D
L
L
L
L
L
L
L
L
L
L
L
D
U
a
a
"}
(15,1,1) = {"
a
a
U
U
U
D
D
L
L
L
L
L
L
L
D
L
D
T
L
Z
Z
Z
D
L
L
L
L
L
L
L
L
L
L
L
D
U
a
a
"}
(16,1,1) = {"
a
a
U
U
U
U
D
L
L
L
L
L
L
L
L
L
D
L
H
L
H
L
D
L
L
L
L
L
L
L
L
L
D
D
D
U
a
a
"}
(17,1,1) = {"
a
a
U
U
U
D
D
L
L
L
L
L
L
L
L
L
D
L
L
L
L
L
D
L
L
L
L
L
L
L
L
L
D
D
D
U
a
a
"}
(18,1,1) = {"
a
a
U
U
U
D
D
L
L
L
L
L
L
L
L
L
L
L
L
L
L
L
L
L
L
L
L
L
L
L
L
L
D
U
U
U
a
a
"}
(19,1,1) = {"
a
a
U
U
U
D
L
L
L
L
L
L
L
L
L
D
D
L
L
L
u
L
L
L
L
L
L
D
L
L
L
L
D
U
U
U
a
a
"}
(20,1,1) = {"
a
a
U
U
U
D
L
L
L
L
u
L
L
L
L
L
D
L
L
L
L
L
L
L
L
L
L
L
L
L
L
L
D
U
U
U
a
a
"}
(21,1,1) = {"
a
a
U
U
U
D
L
L
L
L
L
L
L
L
L
L
L
L
L
L
L
L
L
L
L
L
L
L
D
L
L
L
D
U
U
U
a
a
"}
(22,1,1) = {"
a
a
U
U
U
D
L
L
L
L
L
D
L
L
L
L
L
L
L
D
D
L
L
L
V
L
L
D
D
L
L
L
D
U
U
U
a
a
"}
(23,1,1) = {"
a
a
U
U
U
D
D
L
L
L
L
D
L
L
L
L
L
L
L
L
L
L
L
L
L
L
L
L
L
L
L
L
D
D
D
U
a
a
"}
(24,1,1) = {"
a
a
U
U
U
U
D
L
L
L
L
L
V
V
L
L
L
L
D
D
L
L
L
D
L
L
L
L
L
L
L
L
D
L
D
U
a
a
"}
(25,1,1) = {"
a
a
U
U
U
U
D
L
L
L
L
L
L
L
L
L
L
L
L
L
L
L
L
L
L
L
L
L
L
L
L
L
D
L
D
U
a
a
"}
(26,1,1) = {"
a
a
U
U
U
D
D
L
L
L
L
L
L
L
L
L
L
L
L
L
L
L
L
L
L
L
L
L
L
u
L
L
L
L
D
U
a
a
"}
(27,1,1) = {"
a
a
U
U
U
D
L
L
L
L
L
L
L
L
L
L
L
L
L
L
L
L
L
L
L
L
L
L
L
L
L
L
L
L
D
U
a
a
"}
(28,1,1) = {"
a
a
U
U
U
D
L
L
L
D
L
L
L
L
L
L
L
L
L
D
L
L
L
L
L
L
L
L
L
L
L
L
L
L
D
U
a
a
"}
(29,1,1) = {"
a
a
U
U
D
D
L
L
L
D
D
L
L
D
D
L
L
L
D
D
L
L
L
L
L
L
D
D
L
L
L
L
L
L
D
U
a
a
"}
(30,1,1) = {"
a
a
U
U
D
L
L
L
L
L
L
L
L
L
L
L
L
L
L
L
L
L
L
L
L
L
D
L
L
L
L
L
L
L
D
U
a
a
"}
(31,1,1) = {"
a
a
U
U
D
L
L
L
L
L
L
L
L
L
L
L
L
L
L
L
L
u
L
L
L
L
L
L
L
L
L
L
L
L
D
U
a
a
"}
(32,1,1) = {"
a
a
U
U
D
D
L
L
L
L
L
L
L
D
D
D
D
D
L
L
L
L
L
L
L
L
L
L
L
L
L
L
L
L
D
U
a
a
"}
(33,1,1) = {"
a
a
U
U
D
D
D
D
D
D
L
L
L
D
U
U
D
D
D
L
L
L
L
D
D
D
D
D
L
L
L
L
D
D
D
U
a
a
"}
(34,1,1) = {"
a
a
U
U
U
U
U
U
U
D
D
D
D
D
U
U
U
U
D
D
L
L
L
D
U
U
U
D
D
D
D
D
D
U
U
U
a
a
"}
(35,1,1) = {"
a
a
U
U
U
U
U
U
U
U
U
U
U
U
U
U
U
U
U
D
D
D
D
D
U
U
U
U
U
U
U
U
U
U
U
U
a
a
"}
(36,1,1) = {"
a
a
a
a
a
a
a
a
a
a
a
a
a
a
a
a
a
a
a
a
a
a
a
a
a
a
a
a
a
a
a
a
a
a
a
a
a
a
"}
(37,1,1) = {"
a
a
a
a
a
a
a
a
a
a
a
a
a
a
a
a
a
a
a
a
a
a
a
a
a
a
a
a
a
a
a
a
a
a
a
a
a
a
"}
