//MAP CONVERTED BY dmm2tgm.py THIS HEADER COMMENT PREVENTS RECONVERSION, DO NOT REMOVE
"a" = (
/turf/closed/wall,
/area/shuttle/arrival)
"d" = (
/obj/structure/chair/comfy/shuttle{
	dir = 1
	},
/turf/open/floor/mineral/titanium/blue,
/area/shuttle/arrival)
"f" = (
/obj/machinery/power/shuttle_engine/heater{
	dir = 8
	},
/turf/open/floor/plating/airless,
/area/shuttle/arrival)
"g" = (
/obj/machinery/light/floor/has_bulb,
/turf/open/floor/mineral/titanium/blue,
/area/shuttle/arrival)
"i" = (
/turf/open/floor/mineral/titanium/blue,
/area/shuttle/arrival)
"r" = (
/obj/machinery/light/floor/has_bulb,
/obj/structure/tank_dispenser/oxygen{
	pixel_x = -1;
	pixel_y = 2
	},
/turf/open/floor/mineral/titanium/blue,
/area/shuttle/arrival)
"s" = (
/obj/structure/chair/comfy/shuttle,
/turf/open/floor/mineral/titanium/blue,
/area/shuttle/arrival)
"u" = (
/obj/structure/window/reinforced/spawner/directional/west,
/obj/machinery/light/floor/has_bulb,
/turf/open/floor/mineral/titanium/blue,
/area/shuttle/arrival)
"E" = (
/obj/structure/window/reinforced/spawner/directional/west,
/obj/structure/chair/comfy/shuttle,
/turf/open/floor/mineral/titanium/blue,
/area/shuttle/arrival)
"G" = (
/obj/structure/window/reinforced/spawner/directional/west,
/obj/structure/chair/comfy/shuttle{
	dir = 1
	},
/turf/open/floor/mineral/titanium/blue,
/area/shuttle/arrival)
"J" = (
/obj/machinery/light/floor/has_bulb,
/obj/structure/table,
/turf/open/floor/mineral/titanium/blue,
/area/shuttle/arrival)
"M" = (
/obj/effect/spawner/structure/window/reinforced,
/turf/open/floor/plating/airless,
/area/shuttle/arrival)
"O" = (
/obj/structure/fans/tiny,
/obj/machinery/door/airlock/external,
/turf/open/floor/mineral/titanium/blue,
/area/shuttle/arrival)
"T" = (
/obj/machinery/power/shuttle_engine/propulsion{
	dir = 8
	},
/turf/open/floor/plating/airless,
/area/shuttle/arrival)
"V" = (
/obj/docking_port/mobile/arrivals,
/obj/structure/disposalpipe/segment{
	dir = 4;
	invisibility = 101
	},
/turf/closed/wall,
/area/shuttle/arrival)

(1,1,1) = {"
T
T
T
T
T
"}
(2,1,1) = {"
f
f
f
f
f
"}
(3,1,1) = {"
M
E
u
G
M
"}
(4,1,1) = {"
M
s
i
d
M
"}
(5,1,1) = {"
M
s
i
d
M
"}
(6,1,1) = {"
M
s
g
d
M
"}
(7,1,1) = {"
M
s
i
d
M
"}
(8,1,1) = {"
M
i
i
J
M
"}
(9,1,1) = {"
M
i
i
r
M
"}
(10,1,1) = {"
M
O
V
a
M
"}
