//MAP CONVERTED BY dmm2tgm.py THIS HEADER COMMENT PREVENTS RECONVERSION, DO NOT REMOVE
"a" = (
/obj/effect/decal/cleanable/blood,
/turf/open/floor/iron/airless,
/area/template_noop)
"r" = (
/obj/structure/sign/warning/biohazard/directional/east,
/turf/open/space/basic,
/area/template_noop)
"s" = (
/obj/structure/sign/warning/biohazard/directional/west,
/turf/open/space/basic,
/area/template_noop)
"u" = (
/obj/effect/mob_spawn/corpse/human/cargo_tech,
/turf/open/floor/iron/airless,
/area/template_noop)
"D" = (
/turf/closed/wall/r_wall,
/area/template_noop)
"L" = (
/obj/effect/mob_spawn/corpse/human/assistant,
/turf/open/floor/iron/airless,
/area/template_noop)
"P" = (
/obj/machinery/door/poddoor/shutters,
/turf/open/floor/iron/airless,
/area/template_noop)
"Q" = (
/turf/open/space/basic,
/area/template_noop)
"S" = (
/obj/structure/sign/warning/directional/east,
/turf/open/space/basic,
/area/template_noop)
"W" = (
/turf/open/floor/iron/airless,
/area/template_noop)
"X" = (
/obj/structure/sign/warning/directional/west,
/turf/open/space/basic,
/area/template_noop)
"Z" = (
/mob/living/simple_animal/hostile/megafauna/blood_drunk_miner/hunter,
/obj/effect/decal/cleanable/blood,
/turf/open/floor/iron/airless,
/area/template_noop)

(1,1,1) = {"
Q
Q
Q
S
Q
r
Q
"}
(2,1,1) = {"
D
D
D
D
D
D
D
"}
(3,1,1) = {"
D
a
L
a
a
W
P
"}
(4,1,1) = {"
D
W
Z
W
a
L
P
"}
(5,1,1) = {"
D
u
W
a
W
a
P
"}
(6,1,1) = {"
D
D
D
D
D
D
D
"}
(7,1,1) = {"
Q
Q
Q
X
Q
s
Q
"}
