//MAP CONVERTED BY dmm2tgm.py THIS HEADER COMMENT PREVENTS RECONVERSION, DO NOT REMOVE
"a" = (
/turf/closed/mineral/random/asteroid/tospace,
/area/template_noop)
"f" = (
/obj/structure/table,
/obj/item/coin/diamond,
/obj/item/coin/diamond{
	pixel_y = 4
	},
/obj/item/coin/diamond{
	pixel_x = 7
	},
/turf/open/misc/asteroid/airless/tospace,
/area/template_noop)
"m" = (
/obj/structure/tank_holder/oxygen,
/turf/open/misc/asteroid/airless/tospace,
/area/template_noop)
"q" = (
/obj/structure/bed/double,
/obj/effect/spawner/random/bedsheet/double,
/turf/open/misc/asteroid/airless/tospace,
/area/template_noop)
"r" = (
/obj/structure/table,
/turf/open/misc/asteroid/airless/tospace,
/area/template_noop)
"y" = (
/turf/open/space/basic,
/area/template_noop)
"D" = (
/obj/item/stack/sheet/bluespace_crystal/five,
/obj/structure/table,
/turf/open/misc/asteroid/airless/tospace,
/area/template_noop)
"N" = (
/obj/structure/table,
/obj/machinery/microwave,
/turf/open/misc/asteroid/airless/tospace,
/area/template_noop)
"O" = (
/obj/structure/dresser,
/turf/open/misc/asteroid/airless/tospace,
/area/template_noop)
"Q" = (
/obj/machinery/door/airlock/survival_pod,
/obj/structure/fans/tiny,
/turf/open/misc/asteroid/airless/tospace,
/area/template_noop)
"R" = (
/obj/machinery/portable_atmospherics/canister/air,
/turf/open/misc/asteroid/airless/tospace,
/area/template_noop)
"S" = (
/obj/structure/table,
/obj/effect/spawner/random/food_or_drink/donkpockets,
/turf/open/misc/asteroid/airless/tospace,
/area/template_noop)
"T" = (
/obj/structure/table,
/obj/item/pickaxe/diamond,
/turf/open/misc/asteroid/airless/tospace,
/area/template_noop)
"X" = (
/turf/open/misc/asteroid/airless/tospace,
/area/template_noop)

(1,1,1) = {"
y
y
y
a
a
a
y
y
y
"}
(2,1,1) = {"
y
a
a
a
a
a
a
a
y
"}
(3,1,1) = {"
y
a
D
r
T
X
m
a
y
"}
(4,1,1) = {"
a
a
f
X
X
X
X
a
a
"}
(5,1,1) = {"
a
a
O
X
R
X
X
X
Q
"}
(6,1,1) = {"
a
a
X
X
X
X
r
a
a
"}
(7,1,1) = {"
y
a
q
X
S
N
r
a
y
"}
(8,1,1) = {"
y
a
a
a
a
a
a
a
y
"}
(9,1,1) = {"
y
y
y
a
a
a
y
y
y
"}
