//MAP CONVERTED BY dmm2tgm.py THIS HEADER COMMENT PREVENTS RECONVERSION, DO NOT REMOVE
"a" = (
/turf/open/floor/plating/dirt/jungleland/toxic_pit,
/area/ruin/unpowered/jungleland)
"d" = (
/obj/structure/closet/crate/coffin{
	opened = 1
	},
/turf/open/water/toxic_pit,
/area/ruin/unpowered/jungleland)
"g" = (
/turf/open/water/toxic_pit,
/area/ruin/unpowered/jungleland)
"h" = (
/turf/open/water/toxic_pit,
/area/template_noop)
"j" = (
/obj/structure/table/wood,
/obj/item/candle/infinite{
	lit = 1
	},
/turf/open/floor/plating/dirt/jungleland/toxic_pit,
/area/ruin/unpowered/jungleland)
"k" = (
/obj/item/pickaxe/mini,
/turf/open/floor/plating/dirt/jungleland/toxic_pit,
/area/template_noop)
"v" = (
/mob/living/simple_animal/hostile/skeleton,
/turf/open/floor/plating/dirt/jungleland/toxic_pit,
/area/ruin/unpowered/jungleland)
"w" = (
/mob/living/simple_animal/hostile/skeleton,
/turf/open/floor/plating/ashplanet/rocky/jungle,
/area/ruin/unpowered/jungleland)
"y" = (
/obj/structure/table/wood,
/turf/open/floor/plating/dirt/jungleland/toxic_pit,
/area/ruin/unpowered/jungleland)
"z" = (
/turf/open/floor/plating/dirt/jungleland/toxic_pit,
/area/template_noop)
"D" = (
/obj/structure/mineral_door/wood,
/turf/open/floor/plating/ashplanet/rocky/jungle,
/area/ruin/unpowered/jungleland)
"E" = (
/mob/living/simple_animal/hostile/skeleton,
/turf/open/water/toxic_pit,
/area/ruin/unpowered/jungleland)
"I" = (
/obj/item/candle/infinite{
	lit = 1
	},
/turf/open/floor/plating/ashplanet/rocky/jungle,
/area/ruin/unpowered/jungleland)
"K" = (
/turf/closed/wall/mineral/iron,
/area/ruin/unpowered/jungleland)
"M" = (
/obj/structure/closet/crate/coffin{
	opened = 1
	},
/turf/open/floor/plating/dirt/jungleland/toxic_pit,
/area/ruin/unpowered/jungleland)
"P" = (
/mob/living/simple_animal/hostile/skeleton/templar,
/turf/open/floor/plating/ashplanet/rocky/jungle,
/area/ruin/unpowered/jungleland)
"T" = (
/obj/item/wisp_lantern,
/turf/open/floor/plating/ashplanet/rocky/jungle,
/area/ruin/unpowered/jungleland)
"V" = (
/turf/closed/mineral/ash_rock/jungle/swamp,
/area/ruin/unpowered/jungleland)
"Z" = (
/turf/open/floor/plating/ashplanet/rocky/jungle,
/area/ruin/unpowered/jungleland)

(1,1,1) = {"
z
h
h
h
h
h
h
h
h
h
h
z
h
h
z
z
z
z
z
z
z
"}
(2,1,1) = {"
h
h
h
h
h
h
h
h
h
h
h
h
h
h
h
h
h
h
z
z
z
"}
(3,1,1) = {"
h
h
V
V
V
V
V
V
V
V
V
V
V
V
V
h
h
h
z
z
z
"}
(4,1,1) = {"
h
V
V
g
a
a
a
a
a
a
a
Z
Z
a
V
V
h
h
h
z
z
"}
(5,1,1) = {"
h
V
a
g
g
g
g
y
j
a
a
Z
Z
a
g
V
h
h
z
z
z
"}
(6,1,1) = {"
h
V
a
g
g
g
g
g
g
a
a
w
Z
a
g
V
h
h
h
h
z
"}
(7,1,1) = {"
h
V
g
g
a
d
g
d
g
a
a
Z
Z
a
g
V
V
V
h
h
z
"}
(8,1,1) = {"
h
V
g
a
a
E
g
g
E
g
a
Z
Z
a
g
g
g
g
V
h
z
"}
(9,1,1) = {"
h
V
g
a
K
g
g
g
g
g
a
Z
Z
a
a
a
g
g
V
h
z
"}
(10,1,1) = {"
h
V
g
a
K
I
Z
I
g
g
a
Z
Z
a
a
a
a
g
V
z
k
"}
(11,1,1) = {"
h
V
g
a
K
Z
T
P
D
Z
Z
Z
w
Z
Z
Z
Z
Z
V
z
z
"}
(12,1,1) = {"
h
V
a
a
K
I
Z
I
K
a
a
Z
Z
a
a
a
a
a
V
z
z
"}
(13,1,1) = {"
h
V
a
a
K
K
K
K
K
a
a
Z
Z
a
a
a
a
a
V
h
z
"}
(14,1,1) = {"
h
V
a
a
v
a
a
a
a
a
a
Z
Z
M
v
a
a
a
V
h
h
"}
(15,1,1) = {"
h
V
a
a
a
a
a
a
a
a
a
w
Z
a
a
V
V
V
h
h
h
"}
(16,1,1) = {"
h
V
a
a
a
a
a
a
a
a
M
Z
Z
a
a
V
h
h
h
h
z
"}
(17,1,1) = {"
h
V
a
a
j
y
j
y
j
a
a
Z
Z
a
a
V
h
h
h
h
z
"}
(18,1,1) = {"
h
V
V
a
a
a
g
g
g
a
a
Z
Z
a
V
V
h
h
h
z
z
"}
(19,1,1) = {"
h
h
V
V
V
V
V
V
V
V
V
V
V
V
V
h
h
h
h
z
z
"}
(20,1,1) = {"
h
h
h
h
h
h
h
h
h
h
h
h
h
h
h
h
h
h
h
z
z
"}
(21,1,1) = {"
z
z
z
h
h
h
z
z
h
h
h
h
z
z
h
h
h
h
z
z
z
"}
