//MAP CONVERTED BY dmm2tgm.py THIS HEADER COMMENT PREVENTS RECONVERSION, DO NOT REMOVE
"a" = (
/obj/structure/barricade/wooden,
/turf/open/floor/plating/dirt/jungleland/jungle,
/area/ruin/unpowered/jungleland)
"c" = (
/turf/open/floor/plating/dirt/jungleland/jungle,
/area/ruin/unpowered/jungleland)
"d" = (
/obj/effect/decal/cleanable/blood/footprints,
/area/ruin/unpowered/jungleland)
"e" = (
/obj/effect/decal/cleanable/blood,
/turf/open/floor/plating/dirt/jungleland/jungle,
/area/ruin/unpowered/jungleland)
"g" = (
/obj/effect/decal/cleanable/blood,
/area/ruin/unpowered/jungleland)
"h" = (
/obj/effect/decal/cleanable/blood/footprints{
	dir = 8
	},
/turf/open/floor/plating/dirt/jungleland/jungle,
/area/ruin/unpowered/jungleland)
"o" = (
/obj/item/organ/ears/cat,
/area/ruin/unpowered/jungleland)
"u" = (
/obj/item/organ/tail/cat,
/turf/open/floor/plating/dirt/jungleland/jungle,
/area/ruin/unpowered/jungleland)
"v" = (
/obj/effect/mob_spawn/human/miner,
/obj/effect/decal/cleanable/blood,
/obj/effect/mob_spawn/human/corpse/psychost,
/turf/open/floor/plating/dirt/jungleland/jungle,
/area/ruin/unpowered/jungleland)
"z" = (
/turf/template_noop,
/area/template_noop)
"A" = (
/obj/effect/decal/cleanable/blood/splatter,
/turf/open/floor/plating/dirt/jungleland/jungle,
/area/ruin/unpowered/jungleland)
"K" = (
/obj/item/toy/cattoy,
/area/ruin/unpowered/jungleland)
"L" = (
/obj/structure/mineral_door/wood,
/obj/structure/barricade/wooden/crude,
/turf/open/floor/plating/dirt/jungleland/jungle,
/area/ruin/unpowered/jungleland)
"M" = (
/turf/open/floor/plating/dirt/jungleland/jungle,
/area/template_noop)
"N" = (
/obj/effect/decal/cleanable/blood/drip,
/area/ruin/unpowered/jungleland)
"O" = (
/obj/effect/decal/cleanable/blood/old,
/turf/open/floor/plating/dirt/jungleland/jungle,
/area/ruin/unpowered/jungleland)
"P" = (
/obj/effect/decal/cleanable/blood/footprints{
	dir = 1
	},
/turf/open/floor/plating/dirt/jungleland/jungle,
/area/ruin/unpowered/jungleland)
"Q" = (
/obj/item/shovel,
/turf/open/floor/plating/dirt/jungleland/jungle,
/area/template_noop)
"Y" = (
/area/ruin/unpowered/jungleland)
"Z" = (
/turf/closed/wall/mineral/wood/nonmetal,
/area/ruin/unpowered/jungleland)

(1,1,1) = {"
z
z
z
z
z
z
z
z
z
z
z
z
z
z
z
"}
(2,1,1) = {"
z
Z
Z
Z
Z
Z
a
Z
Z
z
z
z
z
z
z
"}
(3,1,1) = {"
z
Z
c
Y
Y
Y
c
c
Z
M
M
z
z
z
z
"}
(4,1,1) = {"
z
Z
c
Y
d
u
c
e
Z
M
M
M
z
z
z
"}
(5,1,1) = {"
z
Z
O
c
g
Y
N
c
Z
M
M
M
M
z
z
"}
(6,1,1) = {"
z
Z
N
K
Y
v
c
P
L
M
M
M
M
z
z
"}
(7,1,1) = {"
z
a
Y
e
h
A
Y
Y
Z
M
M
Q
M
z
z
"}
(8,1,1) = {"
z
Z
c
c
c
Y
g
Y
Z
M
M
M
M
z
z
"}
(9,1,1) = {"
z
Z
o
Y
c
N
Y
Y
Z
M
M
M
z
z
z
"}
(10,1,1) = {"
z
Z
Z
Z
a
Z
Z
Z
Z
M
M
M
z
z
z
"}
(11,1,1) = {"
z
z
M
M
M
M
M
M
M
M
M
M
z
z
z
"}
(12,1,1) = {"
z
z
M
M
M
M
M
M
M
M
M
M
M
z
z
"}
(13,1,1) = {"
z
z
z
M
M
M
M
M
M
M
M
M
z
z
z
"}
(14,1,1) = {"
z
z
z
z
z
z
z
M
M
M
z
z
z
z
z
"}
(15,1,1) = {"
z
z
z
z
z
z
z
z
z
z
z
z
z
z
z
"}
